R 1280 720
NO ./textures/purplestone.xpm
SO ah
WE ./
EA ./
S sprite_path
C 100,0,0
F 255,0,10

11111111111
10000000001
10000000001
10000N00001
10000000001
10000000001
11111111111
