R 320 200
NO ./textures/wood.xpm
SO textures/bluestone.xpm
WE ./textures/colorstone.xpm
EA ./textures/purplestone.xpm
S ./textures/barrel.xpm
C 242,126,58
F 155, 89,217

11111111111111
12002222222201
10210001000001
10002000001021
10000000000001
12011020101201
11001101100001
110010N0100001
01111111111111
