R 320 200
NO ./textures/purplestone.xpm
SO ah
WE ./
EA ./
S sprite_path
C 100,0,0
F 255,0,10

11111
10001
10001
10001
10001
10N01
11111
