R 320 200
NO ./textures/wood.xpm
SO textures/bluestone.xpm
WE ./textures/colorstone.xpm
EA ./textures/purplestone.xpm
S ./textures/barrel.xpm
C 242,126,58
F 155, 89,217

11111111111111
12220000200001
10010001000001
10000000001001
12000000000001
10011020101001
11001101100001
110010N0100021
01111111111111
2
