R 740 725
NO ./textures/purplestone.xpm
SO textures/bluestone.xpm
WE ./textures/colorstone.xpm
EA ./textures/wood.xpm
S sprite_path
C 100,0,150
F 200,20,0

11111111
10000001
10010W01
11000001
01111111
