	R 300 200	
 NO 	./
SO ah
WE ./
EA ./

S	sprite_path
F 255,0 10
C 100, 0, 0

0000000000000
11111111111110
1000000000010
1010001111110
11121111     1
10000001111111
10N01111
111011
11111
11111111111
11111
1111111111
