R 320 200
NO ./textures/purplestone.xpm
SO ah
WE ./
EA ./
S sprite_path
C 100,0,0
F 255,0,10

1111111
1000001
1000001
1000001
1000001
1000001
1000001
1000001
1000001
100N001
1111111
