F 217, 0,255
R 320 200
NO ./textures/barrel.xpm
SO ./textures/512.xpm
C 255,126,0
EA ./textures/greystone.xpm
S ./textures/amethyst_cluster.xpm
WE ./textures/amethyst_block.xpm

111111111111111111111111111111111111111111111111111111111111111111111111111111111111111111111111111111111111111111111111111111111111111111111111111111111111111111111111111111111111111111111111111111111111111111111111111111111111111111111111111111111111111111111111111111111111111111111111111111111111111111111111111111111111111111111
102000000000000000000000000000000000000000000000000000000000000000000000000000000000000000000000000000000000000000000000000000000000000000000000000000000000000000000000000000000000000000000000000000000000000000000000000000000000000000000000000000000000000000000000000000000000000000000000000000000000000000000000000000000000000000021
120100010000011111110111111111111111111111111111111110000000000000000000000000000111111111111111111111111111111111111111111111111111111111111111111111111111111111111111111111111111111111111111111111111111111111111111111111111111111111111111111111111111111111111111111111111111111111111111111111111111111111111111111111111111111111111
1000000000100100000000000000000000000000000000000000000000000000000000000000000001
120000 000000122200000000000000000000000000000000000000000000000000000000000000001
 001102010100100000000000000000000000000000000000000000000000000000000000000000001
1100110110000100000000000000000000000000000000000000000000000000000000000000000001
110010N010002100000000000000000000000000000000000000000000000000000000000000000001
0111111111111111111111111111111111111111111111111111111111111111111111111111111111
2
