R 1920 1080
NO ./textures/wood.xpm
SO textures/bluestone.xpm
WE ./textures/amethyst_block.xpm
EA ./textures/rock.xpm
S ./textures/amethyst_cluster.xpm
C 242,126,58
F 155, 89,217

11111111111111
10200000200001
12010001000001
10000000001001
12000000000001
10011020101001
11001101100001
110010N0100021
01111111111111
2
