R 400 500
NO ./textures/colorstone.xpm
SO textures/bluestone.xpm
WE ./textures/amethyst_block.xpm
EA ./textures/rock.xpm
S ./textures/amethyst_cluster.xpm
C 242,126,24
F 155, 89,250

11111111111111
12222222222121
10010001000001
10000000001001
10000000000001
10011020101001
11001101100001
110010N0100001
01111111111111
0
