R 320 200
NO ./textures/wood.xpm
SO textures/bluestone.xpm
WE ./textures/colorstone.xpm
EA ./textures/purplestone.xpm
S ./textures/barrel.xpm
C 242,126,58
F 155, 89,217

11111111111111
10000000000001
10010001000001
11000000001001
11000000000001
11011000101001
11001020100001
110010N0100001
01111111111111
