R 304 201
NO 	./
SO ah
WE ./
EA ./
F 255,0 10
S	sprite_path
C 100, 0, 0
11111111
10000001
101N2001
11111111
