 R 201 50
 WE ./
NO ./
	EA ./
 		F 255,0,110
SO ./
S ./
C 100, 0,0


11111111111
   
1N1
1 1
