 R 1000 2500
 WE ./
NO ./
	EA ./
 		F 171,205,239
SO ./
S ./
C 200, 140,40


11111111111
   
1N1
111
