
 R 304 201
	NO  ./
  WE ./
SO ./
	EA ./
 		F 255,1,10
S sprite_path
C 100,0,0

11111111111
10001121111
11110111111
12    0001
100 N 0001
          
111111111 
