 R 1000 500
 WE ./
NO ./
	EA ./
 		F 171,205,239
SO ./
C 200, 140,40
S ./


11111111111
   
1N1
111
