R 2560 1440
NO ./textures/colorstone.xpm
SO textures/bluestone.xpm
WE ./textures/amethyst_block.xpm
EA ./textures/rock.xpm
S ./textures/amethyst_cluster.xpm
C 242,126,24
F 155, 89,250

111
101
101
101
101
101
101
101
101
101
101
101
101
101
101
101
101
101
101
101
101
101
101
101
101
1011111111111111
1000000000000011111111111111111111111111111111111111111111111
111111111111101111111111111111111111111111122222222221211111111111111111111111111111111111111111111111111111111111111111111111111111111111111111111111111
100000000000000000000000000000000000000000000000000000000000000000000000000000000000000000000000000000000000000000000000000000000000000000000000000000001
1111111111111101111111100000000010011111111111111111111111111111111111111111111111111111111111111111111111111111111111111111111111111111111111111111111111
100000000000000111111111111111111111111111
1001102010100001
100011011E000111
100010001000011
10111111111111
101
101
101
101
101
101
101
101
101
101
101
101
101
101
101
101
101
101
101
101
101
101
101
101
101
111
