R 1000 1000
NO ./textures/colorstone.xpm
SO textures/bluestone.xpm
WE ./textures/amethyst_block.xpm
EA ./textures/rock.xpm
F 155, 89,250
C 242,126,24

111
101
101
101
101
101
101
101
101
101
101
101
101
101
101
101
101
101
101
101
101
101
101
101
101
1011111111111111
1000000000000011111111111111111111111111111111111111111111111
111111111111101111111111111111111111111111100000000001011111111111111111111111111111111111111111111111111111111111111111111111111111111111111111111111111
1E0000000000000000000000000000000000000000000000000000000000000000000000000000000000000000000000000000000000000000000000000000000000000000000000000000001
1111111111111101111111100000000010011111111111111111111111111111111111111111111111111111111111111111111111111111111111111111111111111111111111111111111111
100000000000000111111111111111111111111111
1001100010100001
1000110110000111
100010001000011
10111111111111
101
101
101
101
101
101
101
101
101
101
101
101
101
101
101
101
101
101
101
101
101
101
101
101
101
111
