WE ./
C 200, 140,40
NO ./textures/amethyst_block.xpm
EA ./
F 171,205,239
SO ./

11111111111
   001
1N0001
 00001
111111
