R 1000 1000
WE ./textures/redbrick.xpm
C 255, 255, 255
NO ./textures/purplestone.xpm
EA ./textures/greystone.xpm
F 0, 0, 0
SO ./textures/mossy.xpm

000000
11111111111
 W 001
100011
 00001
111111
