R 1000 500
WE ./textures/pillar.xpm
C 200, 140,40
NO ./textures/purplestone.xpm
EA ./textures/greenlight.xpm
F 171,205,239
SO ./textures/test.png

000000
11111111111
 N 001
100011
 00001
111111
