R 1000 1000
WE ./textures/redbrick.xpm
C 255, 255, 255
NO ./textures/amethyst_block.xpm
EA ./textures/greystone.xpm
F 0, 0, 0
SO ./textures/mossy.xpm
S textures/amethyst_cluster.xpm

000000
11111111111
 S 001
100011
 20001
111111
