 R 304 201
	NO  ./textures/purplestone.xpm
	SO ./textures/purplestone.xpm

  WE ./textures/purplestone.xpm

	EA ./textures/purplestone.xpm

 		F 100,1,30
S sprite_path
C 0,100,255
      
10001121111
11110111111
12    0001
100 N 0001
          
111111111 
