R 3000 3000
WE ./textures/redbrick.xpm
C 255, 255, 255
NO ./textures/amethyst_block.xpm
EA ./textures/greystone.xpm
F 100, 100, 100
SO ./textures/mossy.xpm
S2 textures/barrel.xpm
S1 textures/amethyst_cluster.xpm

11111111111
 0 001
100011
 222E1
111111
